R 1920 1080
NO ./path_to_the_north_texture
SO ./path_to_the_south_texture
WE ./path_to_the_west_texture
EA ./path_to_the_east_texture

S ./path_to_the_sprite_texture
F 220,100,0
C 225,30,0

11111111111111111111111111
10000000001100000000000001
1011000001110000002000001
1001000000000000000000001
111111111011000001110000000000001
100000000011000001110111111111111
11110111111111011100000010001
11110111111111011101010010001
110000001101010111000000100011
10002000000000 001100000010001
100000000000000011010100100011
11000001111101011111011110N0111
1111101111110101101111010011111
111111111111111 111111111111